NO assets/north.xpm
SO assets/south.xpm
WE assets/west.xpm
EA assets/east.xpm

F 139,69,19
C 128,152,9

11111111111111111
100000000000000011
11111111111000000111111
1000E000000000000000001
10000000000000001111111
1000000111111111111111111111
1000000000000000000000000001
1111111111111111111111111111
