NO assets/north.xpm
SO assets/south.xpm
WE assets/west.xpm
EA assets/east.xpm
F 139,69,19
C 128,152,9

11111111111111111
10000000000000001
11111111110000001
100E0000000000001
10000000000000001
10000001111111111
10000000000000001
11111111111111111
