11111111111111111
10000000000000001
11111111110000001
10000000000000001
10000000000000001
10000001111111111
100000000S0000001
11111111111111111